A====||=======||==Z
=====||===\\==||===
=====||=======||===
==========||=======
==========||=======
=====\\===||==\\===
==========||=======